مقدمة
   רָגַשׁ هَدَرَ أو رَعَدَ.

   אֱלֹ֘הֵ֤י צִדְקִ֗י إلوهي سدكي

   שִׁגָּי֗וֹן: (شجون) معناها غامض؛ ربما تعني على نغمة حزينة (مثل كلمة شجن في العربية).

   أدوناي

   شاروب، جمعها شاروبيم، كائن روحي مجنح

   רֵמִ֣ים: جمع רֵּ֣ים الثور الوحشي.

   הַבְלֵי: خُبُل تعني شياطين أو أرواح شريرة هي آلهة الأمم.

   רְמִיָּֽה: بعشوائية، كلام مرتخي بلا دليل.

   צַלְעִי֮ ظَلَعِي.

   הֶחֱלִ֣יק حرفيا يحلق بمعنى ينعم الكلام.

   צֶ֣לַע ظَلَعِ.

   הֲנִיעֵ֣מוֹ: يقابل في العربية ناع بمعنى أحنى أو ثنى (غصنًا).

   צְחִיחָה الحر الشديد

   עֲ֝לָמ֗וֹת: جمع עַלְמָה: الفتاة تعني الشابة الصغيرة التي لم تتزوج بعد (راجع تكوين 24: 43؛ خروج 2: 8؛ مزمور 68: 25؛ أمثال 30: 19؛ أغنية الأغاني 1: 3، 6: 8؛ يَشَعْيَاهُو 7: 17)

   חוֹמֵץ: بمعنى فاسد داخليا.

   יָ֭צָא: حرفيا خرجت، والمعنى جحظت.

   רִשְׁפֵי: رشفي جمع רִשְׁפֵ رشف وتعني حرفيا ملتهب، وارتبط بروح شرير عند بني إسرائيل يسبب الحرب أو الحمى والمرض.

   حرفيا זָר֥וּ (زوروا) بمعنى كزائرين.

   לָרְשָׁפִֽים: رشفيم جمع רִשְׁפֵ رشف = ملتهب، وارتبط بروح شرير عند بني إسرائيل يسبب الحمى والمرض.

   רָעִֽים: جمع רַע، وقد تعني شر مادي (دمار) أو أخلاقي.

   לַדֶּ֥בֶר: دِبِر وتعني وباء، وارتبط بروح شرير عند بني إسرائيل يسبب الوباء.

   רְמִיָּֽה: عشوائية، مرتخية لا تصيب هدفًا.

   עָל֔וֹת: المرضعة.

   מִדֶּ֥בֶר: دِبِر وتعني وباء، وارتبط بروح شرير عند بني إسرائيل يسبب الوباء.

   שֵּׁדִים֙: أرواح شريرة في الغالب هي أرواح النفيليم الذين هلكوا في الطوفان.

   תֶּחֱנַ֥ף/ تحنف بمعنى تعوج = حنف في العربية.

   תֹ֙הוּ֙ بلا شكل أو نظام: مادة الخلق الأولى. (راجع تكوين 1: 2)

   הֱלִיצֻ֣נִי = فضحوني.

   = מְעַמֵּֽר من يحزم أو يربط المحصول وهي أيضا بمعنى الربط أو الاسترقاق.

